NO textures/wall_no.xpm
SO textures/wall_so.xpm
WE textures/wall_we.xpm
EA textures/wall_ea.xpm

F 18,53,25
C 153,204,255

111111111111
1        111
1       0001
1000000 0011
10S000000001
111111111111
11         1
111111111111