SO textures/wall_so.xpm
WE textures/wall_we.xpm
NO textures/wall_no.xpm
EA textures/wall_ea.xpm


            
F 18  ,   53 ,  25  
C 153, 204,255

111111111111
1        111
1111111110001
100000000011
10000N000001   1
111111111111  101
11    1   1    1   
111111111111
111
101
111