NO textures/genki_0.xpm
SO textures/genki_1.xpm
WE textures/genki_2.xpm
EA textures/genki_3.xpm

F 220,100,0
C 225,30,0

        1111111111111111111111111
        1000000000110000000000001
        1011000001110000111100001
        1001000000000000100100001
111111111011000001110000111100001
100000000011000001110111111111111
11110111111111011100000000001
11110111111111011101010010001
11000000110101011100000010001    1
10000000000000001100000010001   101
10000000000000001101010010001    1
11000001110101011111011110N0111
11110111 1110101 101111010001
11111111 1111111 11111111111